UNC = "countries/Unclaimed.txt"
SOA = "countries/South_America.txt"
CHR = "countries/Christian_Republic.txt"
AMC = "countries/American_Confederacy.txt"
AMK = "countries/Amerikanisches_Reich.txt"
AUT = "countries/Australia.txt"
EAS = "countries/Eastern_Soviet.txt"
JPF = "countries/Japan.txt"
SIN = "countries/Sino_Empire.txt"
NME = "countries/Mongol_Empire.txt"
DEH = "countries/Delhi.txt"
BIR = "countries/Birma.txt"
SUA = "countries/South_Africa.txt"
DRO = "countries/Droidekia.txt"
JUD = "countries/Judea.txt"
AFR = "countries/Afrikakorps.txt"
OCT = "countries/Occitan.txt"
BRT = "countries/Brittany.txt"
EIR = "countries/Eire.txt"
SCT = "countries/Scotland.txt"
WLE = "countries/Wales.txt"
ENL = "countries/England.txt"
IBE = "countries/Iberia.txt"
NFS = "countries/South_France.txt"
RIT = "countries/Italien.txt"
WPS = "countries/PowderKeg.txt"
BON = "countries/Bosnia.txt"##nnnnnnnnnnnnnnnnnnn
ABA = "countries/Albania.txt"##nnnnnnnnnnnnnnnnnnn
ATH = "countries/Athenia.txt"
ORB = "countries/Orobpa.txt"
TUS = "countries/Turkey.txt"
RMA = "countries/Romania.txt"
SSR = "countries/USSR.txt"##nnnnnnnnnnnnnnnnnnn
NRR = "countries/North_Russia.txt"
SUO = "countries/Suomi.txt"
UKA = "countries/Ukraine.txt"
MAG = "countries/Magyar_Empire.txt"
BFE = "countries/Baltic_Federation.txt"
GGM = "countries/General_Government.txt"
BOH = "countries/Bohemia.txt"##nnnnnnnnnnnnnnnnnnn
NSD = "countries/Nationalsocialistisches_Deutschland.txt"
POG = "countries/Prussian_Opposition_Government.txt"
NFR = "countries/Northern_France.txt"##nnnnnnnnnnnnnnnnnnn
WIN = "countries/Windhoek.txt"
PES = "countries/Pestland.txt"
MGC = "countries/Madagascar.txt"
GZI = "countries/Zimbabwe.txt"
IOT = "countries/Indian_Ocean.txt"
BWA = "countries/Botswana.txt"
NGO = "countries/Ngoni.txt"
CPT = "countries/Cape Town.txt"
LES = "countries/Lesotho.txt"
HPS = "countries/Hawiya Pirate State.txt"
KSO = "countries/Kingdom of Solomon.txt"
TAC = "countries/Tana Contadino.txt"
RED = "countries/Sultanate of the Red Sea.txt"
SNN = "countries/SNNPR.txt"
KHR = "countries/Khartoum.txt"
NUE = "countries/Nuer Kingdom.txt"
BAG = "countries/Baggaras Coalition.txt"
SOZ = "countries/Kingdom of Songhai-Zarma.txt"
BAM = "countries/Bambara Kingdom.txt"
MLK = "countries/Malinke.txt"
SNG = "countries/Senegal.txt"
FUL = "countries/Fula Sultanate.txt"
SUS = "countries/Susu.txt"
TEN = "countries/Temne.txt"
LRA = "countries/Liberation Repubic of Africa.txt"
SSE = "countries/Sia-Senufo.txt"
MOS = "countries/Mossi Kingdom.txt"
DGB = "countries/Dagbon.txt"
ASH = "countries/Ashanti.txt"
WAS = "countries/Wassoulou Tribal Federation.txt"
ABI = "countries/Abidjan Free Ports Authority.txt"
FRO = "countries/The Frontier.txt"
SOK = "countries/Somali Kingdom.txt"
FAN = "countries/fang.txt"
MNG = "countries/Mongo.txt"
KBA = "countries/Kuba.txt"
NMW = "countries/Nyamwezi.txt"
MSL = "countries/Masai-Luo.txt"
TRK = "countries/Turkana.txt"
AZA = "countries/Azande.txt"
BAA = "countries/Baya.txt"
BND = "countries/Banda.txt"
BGR = "countries/Bagirmi.txt"
SAR = "countries/Sara.txt"
FLN = "countries/Fulani.txt"
BNE = "countries/Bane.txt"
TIV = "countries/Tiv.txt"
IBO = "countries/Ibo.txt"
TMI = "countries/TMI-AA.txt"
STM = "countries/StMb-HA.txt"
CHS = "countries/CHSH Ford.txt"
TKK = "countries/TK-KUB.txt"
AIE = "countries/AIE-G.txt"
BMR = "countries/BMR.txt"
SGF = "countries/SGF.txt"
ALC = "countries/African Liberation Conglomerates.txt"
YOR = "countries/Yoruba.txt"
HAU = "countries/Hausa.txt"
NVJ = "countries/navajo.txt"
DES = "countries/deseret.txt"
CLO = "countries/colorado.txt"
IDA = "countries/idaho.txt"
CAS = "countries/cascadia.txt"
WYO = "countries/wyoming.txt"
NEB = "countries/nebraska.txt"
KAN = "countries/kansas.txt"
OKL = "countries/oklahoma.txt"
IND = "countries/indian_state.txt"
DAK = "countries/dakota.txt"
MNA = "countries/montana.txt"
ABT = "countries/alberta.txt"
SAS = "countries/Saskatchewan.txt"
MTB = "countries/manitoba.txt"
CPU = "countries/CPUSA.txt"
IOW = "countries/iowa.txt"
KKK = "countries/KKK.txt"
CAL = "countries/california.txt"
